NO ./textures/42.xpm
SO ./textures/cl_d.xpm
R        900 900
S  ./textures/Meme5.xpm
WE ./textures/wood2.xpm
EA ./textures/metal.xpm
F 175,90,84
C 27,77,184
11111111111
10000000001
10000000001
10002220001
10002220001
10000000001
10000E00001
11111111111