                111111111111111111111111111111
            11111110020000000000000000000000011
            110111000N00200000000000000011111111
1111111111111111111110111000000200000000000000011
1101110000002000000000000000111111111111111111111
110000000000200000000000000011111111
110111000000201111111100000000000011
110111000000201      10000000000000011
110111000000201       110000000000000011
110111000000000111111111000000000000011
110111000000200000000000000011111111111
110111000000200000000000000011
110111000000200000000000000011
110111000000200000000000000011
110111000000200000000000000011111111
111   110111000002000000000000000011
        110111000000200000000000000011
11111111110111000000200000000000000011
11011100000020000000000000001111111111
100000000000000000000000000011
111111111111111111111111111111