R        900 900
NO ./textures/images/own/pared_sangre.xpm
SO ./textures/images/own/pared_musgo.xpm
S  ./textures/sprite.xpm
WE ./textures/images/own/pared_grafity.xpm
EA ./textures/images/own/ladrillo_rojo.xpm
F 175, ,84
C 27,77,184
1111111111111111111111111111111111111111111111111
1000000000000000000000000000000000000000000000011
1011111111111111111111111111111001110000000000011
1011111111111111111111111111111100011000000000011
1000000000000020000000000000000000001000000000011
1111100111111111101111111111111111111000000000011
1000000000000000100000000000000200001111000000011
1111111111111100100111111111111111111111000000011
1000000000000000000000000000000000001110000000011
1110011111111111111111111111111011111111100000011
1000000000000000200000000000000000001111000000011
1111111111111111100111111111111111111111000000011
1000000000000000000000000000000000001110000000011
1111111110000000000000000000011111111111100000011
1000000000000000000000000000000000001111100000011
1000000000000222222222200000000000001111000000011
100000000000020000000000000000000W001111111111011
1000000000000222222222200000000000001111111100011
1000000000000000000000000000000000000200000000011
1000000000000000000000000000000000001111100000011
1111111111111111111111111111111111111111111111111