R        900 900
NO ./textures/images/own/42.xpm
SO ./textures/images/own/cl_d.xpm
S  ./textures/images/own/sprite.xpm
WE ./textures/images/own/wood2.xpm
EA ./textures/images/own/metal.xpm
F 175,130,84
C 27,77,184
11111111111
10000000001
10000000001
10002220001
10002220001
10000000001
10000N00001
11111111111